{
  "Id": "haven_hamlet",
  "Name": "Haven Hamlet",
  "TileSize": 32,
  "PlayerSpawnX": 2,
  "PlayerSpawnY": 2,
  "Portals": [
    { "X": 18, "Y": 7, "TargetZoneId": "whisper_field", "TargetX": 1, "TargetY": 7 }
  ],
  "Tiles": [
    [1,1,1,1,1,1,1,1,1,1,1,1,1,1,1,1,1,1,1,1],
    [1,3,3,3,3,3,3,3,3,3,3,3,3,3,3,3,3,3,3,1],
    [1,3,0,0,0,0,0,0,0,0,0,0,0,0,0,0,0,0,3,1],
    [1,3,0,0,0,0,0,0,0,0,0,0,0,0,0,0,0,0,3,1],
    [1,3,0,0,0,0,0,0,0,0,0,0,0,0,0,0,0,0,3,1],
    [1,3,0,0,0,0,0,0,0,0,0,0,0,0,0,0,0,0,3,1],
    [1,3,0,0,0,0,0,0,0,0,0,0,0,0,0,0,0,0,3,1],
    [1,3,3,3,3,3,3,3,3,3,3,3,3,3,3,3,3,3,4,1],
    [1,3,0,0,0,0,0,0,0,0,0,0,0,0,0,0,0,0,3,1],
    [1,3,0,0,0,0,0,0,0,0,0,0,0,0,0,0,0,0,3,1],
    [1,3,0,0,0,0,0,0,0,0,0,0,0,0,0,0,0,0,3,1],
    [1,3,3,3,3,3,3,3,3,3,3,3,3,3,3,3,3,3,3,1],
    [1,1,1,1,1,1,1,1,1,1,1,1,1,1,1,1,1,1,1,1]
  ]
}
