{
  "Id": "whisper_field",
  "Name": "Whisper Field",
  "TileSize": 32,
  "PlayerSpawnX": 1,
  "PlayerSpawnY": 7,
  "Portals": [
    { "X": 1, "Y": 7, "TargetZoneId": "haven_hamlet", "TargetX": 18, "TargetY": 7 }
  ],
  "Tiles": [
    [1,1,1,1,1,1,1,1,1,1,1,1,1,1,1,1,1,1,1,1],
    [1,2,2,2,2,2,2,2,2,2,2,2,2,0,0,0,0,0,0,1],
    [1,2,2,1,1,2,2,2,1,2,2,2,2,0,1,1,0,1,0,1],
    [1,2,2,1,1,2,0,2,1,2,2,2,2,0,1,1,0,1,0,1],
    [1,2,2,2,2,2,0,2,2,2,2,2,2,0,0,0,0,0,0,1],
    [1,2,2,2,2,2,0,2,1,1,2,2,2,1,1,0,1,1,0,1],
    [1,2,2,2,2,2,0,2,2,2,2,2,2,0,0,0,0,0,0,1],
    [4,3,3,3,3,3,3,3,3,3,3,3,3,3,3,3,3,3,3,1],
    [1,0,0,0,0,0,0,0,0,0,2,2,2,2,2,2,2,2,2,1],
    [1,0,1,1,0,1,1,0,1,0,2,0,2,0,1,0,1,1,2,1],
    [1,0,0,1,0,0,1,0,1,0,2,0,2,0,1,0,0,1,2,1],
    [1,0,0,0,0,0,0,0,1,0,2,2,2,0,0,0,0,0,2,1],
    [1,1,1,1,1,1,1,1,1,1,1,1,1,1,1,1,1,1,1,1]
  ]
}
